S..##########
...#........#
#..#######..#
#..#........#
#..#..#######
#........#..#
####..#..#..#
#.....#......
##########..F